   1111111111111111111111111111111111111111111111111111111111111111111111
   100000000000000000000000000000000000000000000000000000000000000000H101
   0000000000000N00000000000000000000000000000000000000000000000000001001
1111000000000000000000000000000000000000000000000000000000000000000000001
1000000000000000000000000000000000000000000000000000000000000000000001111
1000000000000000000000000000000000000000000000000000000000000000000001
1100000000000000000000000000000000000000000000000000000000000000000001
1111111111111111111111111111111111111111111111111111111111111111111111