NO textures/walls/wall0.xpm

SO textures/walls/wall1.xpm

WE textures/walls/wall2.xpm

EA textures/walls/wall3.xpm

C 0,0,0

F 101, 101, 101

111111111111111111111111111111111
10000000010000000000D000000000001
1000S0000100000000001000000000001
1000000001111100000011111000000011111
1111100000000D00000000001000000000001
    100000000100000000001000000000001
    100000000100000000001000000000001
1111110111111100111111111111111011111
1000000000000000000000000000000000001
1000001111110000000000000010000000001
1010000000000000000000000010000000001
10100000000000A0000000000000000000001
1010000000000000000000000010000000001
1000000000000000001000000010000000001
1000000111110000001000000010000000001
1000000000000000001000000000000000001
1000000000000000000000000000000000001
1111111111111111111111111111111111111
